
111111111111
1P0000000011
1110C0010E11
100000000001
111111111111