111111111111111111111111111
100010000100010000100010001
1P10C00100C00100C0010000E11
100000C001000C001000000C011
1100000C001000C001000000C01
1000000C001000C001000000C01
1100000C001000C001000000C01
1000000C001000C001000000C01
111111111111110111111111111
111111111111110111111111111
100010000100010000100010001
1010C00100C00100C0010000011
100000C001000C001000000C011
1100000C001000C001000000C01
1000000C001000C001000000C01
1100000C001000C001000000C01
1000000C001000C001000000C01
111111111111111111111111111